11111111111111111
10000000000000001
10010100P0010C001
10010001010101001
1001C10E010C01001
10000101010001001
10000000000000001
11111111111111111